20 20
00000000000000000000
00000000000000000000
00000000000000000000
00000000000000000000
00000011110000000000
00000000000000000000
00001111111100000000
00000000000000000000
00111111111111000000
00000000000000000000
00001111111100000000
00000000000000000000
00000011110000000000
00000000000000000000
00000000000000000000
00000000000000000000
00000000000000000000
00000000000000000000
00000000000000000000
00000000000000000000
